0000000000000000000000000000000000000000000000000000000000000000
0002220000000000000000000000000000000000000000000000000000000000
0000020000000000000000000000000000000000000000000000000000000000
0002220000000000000000000000000000000000000000000000000000000000
0002000000000000000000000000000000000000000000000000000000000000
0002220000000000000000000000002222000000000000000000000000000000
3300000000000000022000000220001111000111110011111100111110011111
1123333333322222211333322112001111000100000010000100001000010000
1111111111111111111000011111001111000111000011111000001000010000
1111111111111111111000001100001111000100000010000100001000010000
1111111111111111111000001000001111000111110010000100111110011111
1111111111111111111000001000001111000000000000000000000000000000
1111111111111111111000000000001111000000000000000000000000000000